##############################
#                            #
#   #####################    #
#                            #
#                            #
#                            #
#   #                        #
#   #                        #
#   #                        #
#   #                        #
#   #                        #
#   #        #####           #
#   #            #           #
#   #            #           #
#                #           #
#                #           #
#                #           #
#                #           #
#                #           #
#                #           #
#                #           #
#        #########           #
#                            #
#                            #
#                            #
#                            #
#            #################
#                            #
#                            #
##############################
